#S#################
# #       # #   # #
# #       # #   # #
# ######### ##### #
#                 #
# ### ########### #
# ### ##### ##### #
# ### ##### ##### #
# ### ##### ##### #
# ###             #
################E##
